1111
1E01
1101
1P11
11C1
1101
1101
11C1
1111
