1111111111
1P0C111111
1101111111
1101111111
1101111111
1101111111
1101111111
1111111111
11000000E1
1111111111
