1111111111
1E00000001
1000000001
10P0000001
1000000001
1000000001
1000000001
1000000001
1000000C01
1111111111
