1111111111
1E000001C1
1000000001
10P0011001
1010100001
1010000001
1000100001
1111100001
1C00000C01
1111111111
