1111111111111111111111111111111111
1000000000000000000010000000000001
10P00000000000000000100000C0000001
1000000000000000000010000000000001
10000C0000000000000010000000000001
1000000000000000000010000000000001
1000000000000000000010000000000001
1000000000000000000010000000000001
100000000C000000000010000000000001
1111111111101111111110000000000001
1000000000000000000000000000000001
1000000000000000000000000000000001
1000000000000000000C00000000000001
1000000000000000000000000000000001
1000000000000000000000000000111001
10000000000000000000000000000C1001
1000000000000000000000000000111001
1000000C00000000000000000000000001
1000000000000000000000000000000001
1000000000000000000000000000000001
1000000000000000000000000000000001
1000000000000000000000000000000001
1000000000000000000000000000000001
1000000000000000000000000000000001
1000000000000000000000000000000001
1000000000000000000000000000000001
1000000000000000000000000000000001
1000000000000000000000000000000001
1111111111111111111111111111101111
1111111111111111111111111111101111
1111111111111111111111111111101111
1111111111111111111111111111101111
1111111111111111111111111111101111
1111111111111111111111111111101111
1111111111111111111111111111101111
1111111111111111111111111111101111
1111111111111111111111111111101111
1111111111111111111111111111101111
1111111111111111111111111111101111
1111111111111111111111111111101111
1111111111111111111111111111101111
1111111111111111111111111111101111
1111111111111111111111111111101111
1111111111111111111111111111101111
1111111111111111111111111111101111
1111111111111111111111111111101111
1111111111111111111111111111001111
1C000000000000000000000000000E0001
1111111111111111111111111111111111
