1111111111111111111111111111111111
1000000000000000000000000000000001
100000000P0000000000000000C0000001
1000000000000000000010000000000001
10000C0000000000000010000000000001
1000000000000000000010000000000001
1000000000000000000000000000000001
1000000000000000000000000000000001
100000000C000000000010000000000001
1111111111110110111110000000000001
1000000000000000000000000000000001
1000000000000000000000000000000001
1000000000000000000C00000000000001
1000000000000000000000000000000001
1000000000000000000000000000000001
10000000000000000000000000000C0001
1000000000000E00000000000000000001
1000000C000000000000000000000E0001
1000000000000000000000000000000001
1111111111111111111111111111111111
