11111
10001
1P001
1E0C1
11111
